Food Code	Food Name	Food Desc
MEAT_00_ID	عظم فخذ التنين المجنح	يساعد هذا اللحم على تنشيط مهارات الشجاعة.طهوه لمدة طويلة في اليخنة يجعله مطاطيًا.
MEAT_01_ID	شريحة لحم التنين المجنح الخارجي	لحم يساعد على تنشيط مهارات طعام الشجاعة.يفضل تقديمه كشرائح رفيعة ومشوي علىالفحم.
MEAT_02_ID	بيض التنين المجنح	لحم يساعد على تنشيط مهارات طعام الشجاعة.إنها غنيمة قيّمة من عش التنين المجنح.
MEAT_03_ID	ذيل التنين المجنح	لحم يساعد على تنشيط مهارات طعام الشجاعة.ذيل تنين مجنح طائر. يستحق التجربةمرة على الأقل.
MEAT_04_ID	رأس التنين المجنح	لحم يساعد على تنشيط مهارات طعام الشجاعة.طبق رئيسي من فن الطبخ الراقي، ويقدّم أحيانًافي الولائم الاحتفالية.
MEAT_05_ID	شريحة لحم التنين المجنح	لحم يساعد على تنشيط مهارات طعام الشجاعة.أفضل قطعة عالية القيمة متوفرة منلحم التنين المجنح.
MEAT_06_ID	لحم صعب المضغ	لحم يساعد على تنشيط مهارات طعام المرونة.مواصلة تناول هذا اللحم سهل المضغتضم ميزة إضافية تتمثل في تقوية فكك.
MEAT_07_ID	لحم شائك	لحم يساعد على تنشيط مهارات طعام المرونة.لا يزال ملتصقًا بالقشور الشائكةالتي قُطع منها، مما يستدعي تناوله ببطء وتأن.
MEAT_08_ID	لحم سبائكي	لحم يساعد على تنشيط مهارات طعام المرونة.باهظ الثمن نوعًا ما، لكن أحيانًافقط عليك أن تمتع نفسك.
MEAT_09_ID	لحم صلب	لحم يساعد على تنشيط مهارات طعام المرونة.صلب بما يكفي لكسر سن، ولكن البروتينوالفيتامينات التي يحتوي عليها تجعل الأمر يستحق.
MEAT_10_ID	دجاجة شرسة	لحم يساعد على تنشيط مهارات طعام المرونة.يفضل الاستمتاع بتناوله بتقطيعه بهمجيةوالتهامه بكل حرية.
MEAT_11_ID	لحم نيء مخلل	لحم يساعد على تنشيط مهارات طعام المرونة.إنه مغموس في وصفة صلصة سرية، بالتالي هذا اللحم النيءمتشبع بالنكهات فعليًا.
MEAT_12_ID	لحم أبتونوث	لحم يساعد على تنشيط مهارات طعام الحيوية. المادةالغذائية الرئيسية في النظام الغذائي لأي صيّاد، ,وتستخدمفي عدد كبير من أطباق اللحم.
MEAT_13_ID	أبسيروست	لحم يساعد على تنشيط مهارات طعام الحيوية.تقريبًا يقدّم دائمًا في جرعات كبيرة، وهو المفضلبين الصيّادين النهمين.
MEAT_14_ID	لحم مكعب	لحم يساعد على تنشيط مهارات طعام الحيوية.لحم من نوعية جيدة نسبيًا، مقطع إلى قطعصغيرة بحجم القضمة.
MEAT_15_ID	لحم خاصرة العملاق	لحم يساعد على تنشيط مهارات طعام الحيوية.شريحة جميلة من لحم أبتونوثاللذيذ والمشبع.
MEAT_16_ID	قرص لحم ضخم	لحم يساعد على تنشيط مهارات طعام الحيوية.قرص لحم معد كما يجب أنيكون: تقريبًا ضخم جدًا ليتسع في فمك.
MEAT_17_ID	شريحة لحم حجم كبير	لحم يساعد على تنشيط مهارات طعام الحيوية.شريحة لحم مطهو بشكل جيد ولذيذة للغاية حتى أنه يصعبتركها بعد إحساسك بالشبع.
MEAT_18_ID	كبد أبيض	لحم يساعد على تنشيط مهارات طعام الذكاء.مُفضل بسبب قوامه اللزج.
MEAT_19_ID	ضلع مشوي ضئيل	لحم يساعد على تنشيط مهارات طعام الذكاء.هذا اللحم اللذيذ مشبّع ويمكن أن تدمنه.
MEAT_20_ID	أمعاء لاذعة	لحم يساعد على تنشيط مهارات طعام الذكاء.حين تملء معدتك بهذا الطعام سيكونمن الصعب أن تبقى في مكانك.
MEAT_21_ID	قلب ساخن	لحم يساعد على تنشيط مهارات طعام الذكاء.تتميز قطعة اللحم بقوامها،ويكون أفضل استمتاع بها حين تُقدم ساخنة للغاية.
MEAT_22_ID	لحم بقري غني	لحم يساعد على تنشيط مهارات طعام الذكاء.قطعة لحم سميكة استثنائيةمأخوذة من أفضل جزء في الجسد.
MEAT_23_ID	كبد إوز فاخر	لحم يساعد على تنشيط مهارات طعام الذكاء.قوامه اللين ومذاقه الغنييجعلك تسعى للحصول عليه.
MEAT_24_ID	ديك رومي رديء	لحم يساعد على تنشيط مهارات طعام المدفعية.للأسف أن أغلبه من العظام وليس اللحم.
MEAT_25_ID	لحم ضأن رائع	لحم يساعد على تنشيط مهارات طعام المدفعية.إنه متعدد الاستخدامات، حيث يمكنك إضافته إلى عديدمن الأطباق.
MEAT_26_ID	بيضة آكل النبات	لحم يساعد على تنشيط مهارات طعام المدفعية.إن أعددت عجّة منه، قد تطعم العديدمن الأسر الجائعة.
MEAT_27_ID	ديك رومي ملكي	لحم يساعد على تنشيط مهارات طعام المدفعية.لحمه الوفير يجعله يستحق أكثرمن لقبه. إنه يجلب للديك الرومي الرديء العار.
MEAT_28_ID	لحم ضأن حمم بركانية	لحم يساعد على تنشيط مهارات طعام المدفعية.لحم طري يظهر طعمه الغني أكثرحين يُطهى لفترة أطول.
MEAT_29_ID	ديك رومي للقيصر	لحم يساعد على تنشيط مهاراتطعام المدفعية. فخذ مكتظ باللحمحتى لحم الديك الرومي الملكي لا يضاهيه.
FISH_00_ID	تونة القشور المدببة	سمك يساعد على تنشيط مهارات طعام الشجاعة.لحمها لذيذ كما أن عرفه خطير.
FISH_01_ID	السلمون الملتوي	سمك يساعد على تنشيطمهارات طعام الشجاعة. إنها لئيمةوملتوية وتشبه الثعابين أكثر من السمك.
FISH_02_ID	الأنقليس الشجاع	سمك يساعد على تنشيط مهارات طعام الشجاعة.قضمة واحدة وسيمتلئ قلبك بالشجاعة.
FISH_03_ID	سمك السوشي	سمك يساعد على تنشيط مهارات طعام الشجاعة. لذيذ ويحتويعلى القدر المناسب من الدهون. يحبه الجميع.
FISH_04_ID	الشبوط القديم	سمك يساعد على تنشيط مهارات طعام الشجاعة.سمك ذو مذاق رائع، أٌشيد بطعمهالشهي منذ العصور القديمة.
FISH_05_ID	ذات الذيل الأصفر الخشن	سمك يساعد على تنشيط مهارات طعام الشجاعة.رغم انتقاده بسبب مظهره المبتذل،يعتبر هذا السمك بالفعل خلاصة الشجاعة.
FISH_06_ID	حلزون ضخم	سمك يساعد على تنشيط مهارات طعام المرونة.كلما كانت القوقعة أكبر، ستباع بسعر أعلى.
FISH_07_ID	رقائق المحار	سمك يساعد على تنشيط مهارات طعام المرونة.يمكن تجفيف المحار والاحتفاظ به. ويمكن استخدامهلصنع حساء شهي.
FISH_08_ID	أذن البحر المفضل	سمك يساعد على تنشيط مهارات طعام المرونة.طعام ممتاز من حيث الحجم والمذاق.
FISH_09_ID	أذن البحر البنفسجي	سمك يساعد على تنشيط مهارات طعام المرونة.تغيّر كل من نكهته ومذاقه كثيرًاكما تغيّر لونه.
FISH_10_ID	أذن البحر الثمين	سمك يساعد على تنشيط مهارات طعام المرونة.يشاد بكونه أطيب الأطعمة الشهية.
FISH_11_ID	عمامة بقرن طويل	سمك يساعد على تنشيط مهارات طعام المرونة.لم تكشف الدراسة البيولوجية لهعن فائدة قرونه الطويلة.
FISH_12_ID	تجمّع سردين	سمك يساعد على تنشيط مهارات طعام الحيوية.يتشكل السردين في سرب يشبه الكتيبةلحماية منطقته.
FISH_13_ID	تونة الساموراي	سمك يساعد على تنشيط مهارات طعام الحيوية.يتميز بالنقوش على رأسه التي تشبه خوذة الساموراي.
FISH_14_ID	خيشوم غاجاو	سمك يساعد على تنشيط مهارات طعام الحيوية.رغم أنه يلزم طهيه لمدة طويلة،إلا أن الانتظار يستحق بالتأكيد.
FISH_15_ID	كبد غاجاو	سمك يساعد على تنشيط مهارات طعام الحيوية.إنه سمك لذيذ ومغذييحتوي على دهون جيدة.
FISH_16_ID	تونة شوغون	سمك يساعد على تنشيط مهارات طعام الحيوية.النقوش على طول جسده كله توحيكما لو أنه درع كامل للساموراي.
FISH_17_ID	الشبوط المتوهج	سمك يساعد على تنشيط مهارات طعام الحيوية.يبدو هذا السمك الأحمر المتوهجكما لو أنه مشتعل على الدوام.
FISH_18_ID	القريدس الملتوي	سمك يساعد على تنشيط مهاراتطعام الذكاء. يتميز القريدس بجسده الملتوي الذي يصعب من أكله.
FISH_19_ID	السلطعون المدرّع	سمك يساعد على تنشيط مهارات طعام الذكاء.إنه سمك قشري يبدو كأنهيرتدي درع وهو بنفس الصلابة التي يبدو عليها.
FISH_20_ID	القريدس المرجاني	سمك يساعد على تنشيط مهارات طعام الذكاء.إنه سمك صغير، يمتلك قشرة وردية متوهجة.
FISH_21_ID	السلطعون المحصّن	سمك يساعد على تنشيط مهارات طعام الذكاء.يجذب المتعايشات لتعيش على قشرته،ما يجعل جسده يبدو أكبر مما هو عليه.
FISH_22_ID	القريدس الملكي	سمك يساعد على تنشيط مهارات طعام الذكاء.يعتبر الملك على سائر القريدس الآخر.
FISH_23_ID	السلطعون الألفي	سمك يساعد على تنشيط مهاراتطعام الذكاء. يقال إن هذا السلطعون الرائعيعيش لمدة ألف سنة.
FISH_24_ID	أخطبوط أوسيو	سمك يساعد على تنشيط مهاراتطعام المدفعية. يمتلك قوامًا هشًا يشبه تقريبًا مضغ العظام.
FISH_25_ID	كافيار وردي	سمك يساعد على تنشيط مهارات طعام المدفعية.بيض سمك وردي رائع مملح قليلًا.
FISH_26_ID	حبّار الزنبق	سمك يساعد على تنشيط مهارات طعام المدفعية.يقال إنه يكسبك بعض البصيرة.
FISH_27_ID	الأخطبوط الراقص	سمك يساعد على تنشيط مهارات طعام المدفعية.طهو الأخطبوط يجعل أقدامه تلتف مثل قدمي الراقص.
FISH_28_ID	كافيار وجداني	سمك يساعد على تنشيط مهارات طعام المدفعية.بيض سمك لذيذ للغاية حتى إنه يعتبر غذاء للروح.
FISH_29_ID	الحبّار الحاكم	سمك يساعد على تنشيط مهارات طعام المدفعية.حجم هذا الحبّار يتطلّب حرفيًااعتباره كحاكم مكان ما.
VEGE_00_ID	كرفس فاتن	خضار يساعد على تنشيط مهاراتطعام الشجاعة. بمجرد تذوقه، لن تستطيعمقاومة طعمه.
VEGE_01_ID	رابسكالين	خضار يساعد على تنشيط مهارات طعامالشجاعة. إذا تناولته نيئًا، يكون مذاقه حارًاحتى إن ديفيلجو قد يذرف الدمع.
VEGE_02_ID	صبار الجوهرة	خضار يساعد على تنشيط مهارات طعام الشجاعة.إنه كبير ويحتوي على لحم لذيذ ودسم.
VEGE_03_ID	زهرة التنين	خضار يساعد على تنشيط مهارات طعام الشجاعة.زهرة تحتوي على ثمرة قاسية كقشور التنين المجنح.
VEGE_04_ID	الصبار الملكي	خضار يساعد على تنشيط مهارات طعام الشجاعة.إنه صبار من نوعية فاخرة تكاد تكون ملكية.
VEGE_05_ID	طماطم دسمة	خضار يساعد على تنشيط مهارات طعام الشجاعة.طماطم فاخرة تحتوي على عصارة لذيذة.
VEGE_06_ID	الذرة الحجرية	خضار يساعد على تنشيط مهارات طعام المرونة.ساق الذرة هذا يحتاج تقريبًا إلى قوى خارقةلتقشيره.
VEGE_07_ID	البطاطا الراسخة	خضار يساعد على تنشيط مهارات طعام المرونة.الجذور المتينة التي تمتد منها تجعلمهمة الحصاد شاقة.
VEGE_08_ID	قلنسوة الفطر الفاخر	خضار يساعد على تنشيط مهاراتطعام المرونة. فطر لذيذ، حتى الطهاةاعتادوا على أكله أثناء الطهي.
VEGE_09_ID	فطر القمر المضيء	خضار يساعد على تنشيط مهارات طعام المرونة.إنه فطر يضيء بشكل خافت مثل القمر.
VEGE_10_ID	فطر الروح	خضار يساعد على تنشيط مهارات طعام المرونة.توهّج هذا الفطر لا يمكن وصفه إلا بأنه من عالمآخر.
VEGE_11_ID	الفطر الملوّث	خضار يساعد على تنشيط مهارات طعام المرونة.ليس غريبًا أنه يصعب إيجاده، فقد كان يُعتقدأنه مجرد أسطورة.
VEGE_12_ID	اليقطين الضخم	خضار يساعد على تنشيط مهارات طعام الحيوية.إنه يقطين فاخر ورائع ومتناسب.لكن مذاقه غالبًا يكون بعيد كل البعد عن هيئته.
VEGE_13_ID	بصل الهراوة	خضار يساعد على تنشيط مهارات طعام الحيوية.كما يوحي اسمه، فإن مذاقه الحار ومظهرهالقاسي غالبًا يجعلانه كالأوغريش.
VEGE_14_ID	زهرة البريق	خضار يساعد على تنشيط مهارات طعام الحيوية.إن عبيرها يرسم في العقل صورةخافتة وملوّنة لضوء الشمس.
VEGE_15_ID	عشب قبلة الشمس	خضار يساعد على تنشيط مهارات طعام الحيوية.يزعم أن هذا العشب يمتلك قوى علاجية عديدة.
VEGE_16_ID	الزهرة الذهبية	خضار يساعد على تنشيط مهارات طعام الحيوية.زهرة تطلق أشعة جميلة ذهبية.
VEGE_17_ID	كمأة الملك	خضار يساعد على تنشيط مهارات طعام الحيوية.كمية قليلة منه تضيف قدر كبير من النكهاتالرائعة إلى أي صحن.
VEGE_18_ID	كرفس عطِر	خضار يساعد على تنشيط مهارات طعام الذكاء.إن نكهته تختلف كثيرًا حسبطريقة إعداده.
VEGE_19_ID	فلفل حلو منشور	خضار يساعد على تنشيط مهارات طعام الذكاء.يختلف لونه كثيرًا وفقًا لطريقةتحضيره.
VEGE_20_ID	فاكهة متعفنة	خضار يساعد على تنشيط مهارات طعام الذكاء.نضجت الفاكهة رغم الظروفالقاسية في الوادي المتعفن.
VEGE_21_ID	توت فردوسي	خضار يساعد على تنشيط مهارات طعام الذكاء.يُشاد بمذاقه كما لو أنه طعام من أفضل الأماكن.
VEGE_22_ID	فاكهة فردوسية	خضار يساعد على تنشيط مهارات طعام الذكاء.إنها تمتلك نكهة ساحرة للغاية تبدو كما لو أنهامن عالم آخر.
VEGE_23_ID	ملفوف المليون طيّة	خضار يساعد على تنشيط مهارات طعام الذكاء.إنه يتميز بتركيبته الاستثنائية وذلك بفضلعدد طيّات أوراقه الذي لا يحصى.
VEGE_24_ID	بذرة كوت-كو	خضار يساعد على تنشيط مهارات طعام المدفعية.مذاق هذه البذرة العرضيّة حار بما يكفيليجعلك تنفث نارًا مثل يان كوت-كو.
VEGE_25_ID	مانجو مذابة	خضار يساعد على تنشيط مهارات طعام المدفعية.هذه المانجو تنضج بسرعة بعد قطفها،وتواصل ثورانها بسبب الحرارة لفترة طويلة بعد ذلك.
VEGE_26_ID	فاكهة حجرية	خضار يساعد على تنشيط مهارات طعام المدفعية.تمتلك هذه الفاكهة قشرة قاسية مثل الحجر.
VEGE_27_ID	التفاح المقدس	خضار يساعد على تنشيط مهارات طعام المدفعية.إنها فاكهة استوائية تنمو بصعوبة.
VEGE_28_ID	فاكهة برية	خضار يساعد على تنشيط مهارات طعام المدفعية.مذاقه الغريب هو المفضل بين خبراء الأطعمة.
VEGE_29_ID	دوريان الزمردي	خضار يساعد على تنشيط مهارات طعام المدفعية.إنها فاكهة نادرة تتوهج كالزمردوتكاد تكون لها القيمة نفسها.
LIQUOR_00_ID	طمي البطاطا	مشروب يساعد على تنشيط مهارات طعام البصيرة.يتم احتساء هذا المشروب بسرعة وسهولة.
LIQUOR_01_ID	خمر التنين	مشروب يساعد على تنشيط مهارات طعام البصيرة.شراب قوي بما يكفي للإطاحة بتنين مجنح،وإن كانت طريقة اختبار الأمر مطروحة للنقاش.
LIQUOR_02_ID	مشروب قاهر العفريت	مشروب يساعد على تنشيط مهاراتطعام البصيرة. هذا المشروب لاذع بما يكفيلحفر ثقب في معدة ديفيلجو.
LIQUOR_03_ID	كهرمان التنين المجنح	مشروب يساعد على تنشيط مهاراتطعام البصيرة. إنه خمر عطِر وعتيق.
LIQUOR_04_ID	مشروب السمكة الذهبية	مشروب يساعد على تنشيط مهارات طعام البصيرة.اعتبر نفسك محظوظًا للحصول على مشروبالكأس المقدس.
LIQUOR_05_ID	ساكي قاتل التنين	مشروب يساعد على تنشيط مهارات طعام البصيرة.اُستخلص نبيذ الأرز وفق عملية تم البحث فيها لفترةطويلة. خلاصة ساكي.
LIQUOR_06_ID	مشروب الصياد	مشروب يساعد على تنشيط مهارات طعام الحظ.إنه أفضل شراب منعش بعد فترة طويلة في الصيد.
LIQUOR_07_ID	براندي نجمي	مشروب يساعد على تنشيط مهارات طعام الحظ.يظهر على ملصق زجاجته نجم الياقوت الأزرقالشهير الخاص بلجنة البحث.
LIQUOR_08_ID	جعة السيد	مشروب يساعد على تنشيط مهارات طعام الحظ.هذا المشروب الغني والناعم تم تخميره مع شعير محمّصوله شعبية بين هواة الخمر.
LIQUOR_09_ID	مشروب راذا	مشروب يساعد على تنشيط مهارات طعام الحظ.إنه مشروب معتق في برميل محروق بواسطةلهب راذالوس الناري.
LIQUOR_10_ID	جعة أستيرا	مشروب يساعد على تنشيط مهارات طعام الحظ.إنه المشروب المحلّي للجنة البحث.ويعتبر الأفضل للاحتساء أثناء النخب الاحتفالي.
LIQUOR_11_ID	النبيذ المبارك	مشروب يساعد على تنشيط مهارات طعام الحظ.يحمل المشروب الرقم القياسي لبقائه أطول فترةعلى قمة الترتيب الشهري لنبيذ الصياد.
LIQUOR_12_ID	جرعة قرن عظيم	مشروب يساعد على تنشيط مهارات طعام الاستعداد.مصنوع من مسحوق قرون الحيواناتالتي توجد في نطاق الصقيع.
LIQUOR_13_ID	جعة مباركة	مشروب يساعد على تنشيط مهارات طعام الاستعداد.عادة تُمنح للمسافرين كميدالية حظ جيد للطريق.
LIQUOR_14_ID	شراب الزبد	مشروب يساعد على تنشيط مهارات طعام الاستعداد.إنه مشروب منعش مصنوع من قبعيّة محصودة حديثًا من النطاق.
LIQUOR_15_ID	نبيذ العسل المُحصن	مشروب يساعد على تنشيط مهارات طعام الاستعداد.تقوم المكونات الطبيعية المُنتقاة بعناية في هذا المشروب بتدفئة الجسم إلى الصميم.
LIQUOR_16_ID	شراب ساحر	مشروب يساعد على تنشيط مهارات طعام الاستعداد.تسحر نكهة هذه الفاكهة الحلوة مَن يشم رائحتها.
LIQUOR_17_ID	شراب مكسيكي	مشروب يساعد على تنشيط مهارات طعام الاستعداد.مشروب فعال يتناوله الصيادون المتهورون لإثبات قوة تحملهم.
LIQUOR_18_ID	شراب جليدي	مشروب يساعد على تنشيط مهارات طعام الرائد.يُقدم شراب المطعم رفيع المستوى بمكعبات الثلج،يُقدم الآن وفوقه طبقة ثلجية.
LIQUOR_19_ID	شراب النخب	مشروب يساعد على تنشيط مهارات طعام الرائد.شراب مُعتق يُتناول عند الاحتفالبالصيد الناجح والمناسبات السعيدة الأخرى.
LIQUOR_20_ID	جرعة الثلج الذائب	مشروب يساعد على تنشيط مهارات طعام الرائد.مذاق الثلج الذائب الصافي يجعل تناول هذا الشراب نخبًا تقليديًا بعد القتال.
LIQUOR_21_ID	شراب كوكتيل الثلج	مشروب يساعد على تنشيط مهارات طعام الرائد.شراب فاخر يُقدم فوق قطع فضية من رقائق الثلج الكثيفة.
LIQUOR_22_ID	شراب بلور ثلجي	مشروب يساعد على تنشيط مهارات طعام الرائد.شراب شفاف من الواضح أنه يبدو وكأن الفقاعات تصعد خارج كوب فارغ.
LIQUOR_23_ID	شراب روحي حارق	مشروب يساعد على تنشيط مهارات طعام الرائد.تُشعل رشفة واحدة من هذه الجعة الفعالة نارًا تبدأ من المعدة وصولًا إلى كل الأعضاء.
